R 1024 1000
NO ./textures/1.xpm
SO ./textures/2.xpm
WE ./textures/3.xpm
EA ./textures/4.xpm

S ./textures/slugma.xpm
F 200,220,100
C 255,40,255

             11111111   11111111
            100000000111000000001
            100111000011120000211
            100001000000001110001
111111111111011000000000000000001
10000000000001000010000000111111
100000000011122111100010000000001
1000000000000000020000011100000011111111
11111111101000000000001000000000000001
11111111101000000000001000000000000001
11111111101000000000001000000000000001
1111111110100002220122220000001111111
1111111110100000000000100000001111111
1111111110100N000000001000000000000001
11111111101000000000001000000000000001
1111111110100000000000100001000000001
1111111110100000000000100000011111110111111111
111111111111111111111111111111111111111111111

111111111111111111111111111111111111111111111
111111111020000000000010000001      1100000001
1002000002000000200000000000011111111 11111111
1110000000012000002010001000000011111
1110000000012000002010001000000011111   1
1110000000012000002010001000000011111   1
111000000001200000201000100000001111111111111
1110000000012000002010001000000022222222222221
111111111111111111111111111111111111111111111
