R  1000 1000
NO ./textures/1.xpm
SO ./textures/2.xpm
WE ./textures/3.xpm
EA ./textures/4.xpm

S ./textures/slugma.xpm
F 224,172,105
C 205,249,255

11111111111111111
10000000000000001
10002000000000001
10000000000000001
10000000000020001
10020000000000001
100000000000N0001
10000000000000001
10000000000000001
10000000000000001
10000000000000001
11111111111111111
